13 8  4  11 0  1  10 8  4  1 2 1 1
12 5  2  10 0  8  2  13 4  1 0 1 1
4 6 9 8 1 2 10 0 14 1 0 1 2
11 8 4 6 2 1 0 10 13 0 1 0 2
13 10 12 3 7 8 2 4 0 1 2 2 2
10 12 6 0 3 1 8 1 14 0 2 0 1
6 12 14 2 4 9 1 5 0 0 0 2 2
0 9 12 13 8 4 7 3 1 1 2 0 0
12 4 0 3 2 7 8 14 10 1 0 2 0